with_error	corrected
aabdominal	abdominal
aasthma	asthma
aback	back
abadominal	abdominal
abbcess	abcess
abbdominal	abdominal
abbrasion	abrasion
abccess	abcess
abcesses	abcess
abcesss	abcess
abcessto	abcess
abck	back
abcsess	abscess
abdaminal	abdominal
abdcess	abcess
abddominal	abdominal
abdeominal	abdominal
abdiminal	abdominal
abdimonal	abdominal
abdiominal	abdominal
abdminal	abdominal
abdmoinal	abdominal
abdmominal	abdominal
abdmonal	abdominal
abdmonial	abdominal
abdmoninal	abdominal
abdnomal	abdominal
abdnominal	abdominal
abdnormal	abnormal
abdoiminal	abdominal
abdoimnal	abdominal
abdomainal	abdominal
abdomainl	abdominal
abdomenal	abdominal
abdoment	abdomen
abdomianal	abdominal
abdomianl	abdominal
abdomibnal	abdominal
abdomiinal	abdominal
abdomijnal	abdominal
abdomimnal	abdominal
abdominaal	abdominal
abdominakl	abdominal
abdominall	abdominal
abdominalm	abdominal
abdominals	abdominal
abdominanl	abdominal
abdominaol	abdominal
abdominasl	abdominal
abdomincal	abdominal
abdomine	abdomen
abdominial	abdominal
abdominla	abdominal
abdominmal	abdominal
abdominnal	abdominal
abdomional	abdominal
abdomminal	abdominal
abdomnal	abdominal
abdomnial	abdominal
abdomninal	abdominal
abdomoinal	abdominal
abdomonal	abdominal
abdomonial	abdominal
abdomunal	abdominal
abdonmial	abdominal
abdonminal	abdominal
abdoominal	abdominal
abdopminal	abdominal
abdpminal	abdominal
abdscess	abscess
abecess	abscess
abndominal	abdominal
abnomral	abnormal
abnoraml	abnormal
abnormally	abnormal
abnormalt	abnormal
abnormanl	abnormal
abnromal	abnormal
abodminal	abdominal
abodominal	abdominal
abomdinal	abdominal
abraision	abrasion
abraisions	abrasion
abraison	abrasion
abraisons	abrasion
abrasions	abrasion
abrassion	abrasion
abrassions	abrasion
abrastion	abrasion
abruse	abuse
absces	abscess
abscessed	abscess
abscesses	abscess
abscesson	abscess
abscesss	abscess
abscessto	abscess
absdominal	abdominal
absecess	abscess
absecss	abscess
absscess	abscess
absue	abuse
abused	abuse
abuser	abuse
abusive	abuse
acccident	accident
accidental	accident
accidently	accident
accidents	accident
accidentt	accident
accidnet	accident
accute	acute
ached	ache
achey	ache
actue	acute
acutely	acute
adbdominal	abdominal
adbomen	abdomen
adbominal	abdominal
admited	admit
admits	admit
admitt	admit
admitte	admit
aera	area
afetr	after
ahand	hand
ahce	ache
ahces	aches
aknle	ankle
alceration	laceration
alchohol	alcohol
alcholol	alcohol
alchool	alcohol
alcochol	alcohol
alcoholic	alcohol
alcohool	alcohol
alcolhol	alcohol
alelrgic	allergic
alerted	altered
aletered	altered
alleergic	allergic
allegeric	allergic
allegric	allergic
allergey	allergy
allergice	allergic
allergric	allergic
allergyc	allergy
allergys	allergy
allerigc	allergic
allerigic	allergic
allgeric	allergic
allgery	allergy
alllergic	allergic
allregic	allergic
alochol	alcohol
alocohol	alcohol
alterred	altered
alterted	altered
anaemia	anemia
anckle	ankle
andkle	ankle
aneima	anemia
anemias	anemia
anexity	anxiety
aniexty	anxiety
anixety	anxiety
anixiety	anxiety
anixtey	anxiety
ankel	ankle
ankels	ankle
ankkle	ankle
ankles	ankle
anklet	ankle
anklle	ankle
anlke	ankle
anlkle	ankle
annkle	ankle
anusea	nausea
anxeity	anxiety
anxienty	anxiety
anxitey	anxiety
apain	pain
apin	pain
apinful	painful
apins	pains
appeitite	appetite
appendicities	appendicitis
appendiscitis	appendicitis
appetitie	appetite
appetitte	appetite
appettie	appetite
appettite	appetite
aqbdominal	abdominal
arae	area
areas	area
arresst	arrest
arrested	arrest
arrrest	arrest
artial	arterial
asasult	assault
asathma	asthma
asbcess	abscess
asbdominal	abdominal
ashthma	asthma
ashtma	asthma
asmtha	asthma
assalut	assault
assaluted	assaulted
assaulated	assaulted
assaultd	assault
assaulte	assault
assaultg	assault
assaultted	assaulted
assautled	assaulted
asssault	assault
asssaulted	assaulted
assthma	asthma
assualt	assault
assualted	assaulted
assulat	assault
assulated	assaulted
astham	asthma
asthama	asthma
asthema	asthma
asthmaa	asthma
asthmaeg	asthma
asthman	asthma
asthmas	asthma
asthmat	asthma
asthmati	asthma
asthmma	asthma
asthmna	asthma
asthnma	asthma
asthsma	asthma
astmha	asthma
astthma	asthma
astyhma	asthma
aterial	arterial
athsma	asthma
atraumatic	traumatic
atshma	asthma
attacked	attack
attacks	attack
atttack	attack
atwork	work
aweek	week
axniety	anxiety
baack	back
bacck	back
backa	back
backaches	backache
backed	back
backk	back
backl	back
backm	back
backn	back
backof	back
backp	back
backpa	back
backpn	back
backs	back
backx	back
baclk	back
bacvk	back
badominal	abdominal
bakc	back
balck	back
bandemia	anemia
baody	body
baqck	back
basck	back
bback	back
bcak	back
bdoy	body
beahavior	behavior
beahvior	behavior
beathing	breathing
behaivior	behavior
behaivor	behavior
behavioral	behavior
behaviors	behavior
behaviour	behavior
behavoir	behavior
behvaior	behavior
berathing	breathing
bhronchitis	bronchitis
biab	biba
bialteral	bilateral
bibamb	biba
bibdad	biba
bibmes	bibems
biboam	biba
bigtoe	toe
bilate	bite
bilaterall	bilateral
bilaterally	bilateral
bilaterial	bilateral
bilaterla	bilateral
bilatteral	bilateral
billateral	bilateral
biltaeral	bilateral
biol	boil
bipol	boil
bited	bite
biten	bite
biteof	bite
bites	bite
biteto	bite
bitten	bite
bleedding	bleeding
bleedeing	bleeding
bleedg	bleed
bleedi	bleed
bleedig	bleed
bleedign	bleeding
bleediing	bleeding
bleedin	bleed
bleedingg	bleeding
bleedings	bleeding
bleedingx	bleeding
bleedling	bleeding
bleedn	bleed
bleedng	bleed
bleeds	bleed
bleedx	bleed
bleedy	bleed
bleeed	bleed
bleeeding	bleeding
bleeidng	bleeding
bliateral	bilateral
bliste	blister
blleeding	bleeding
bllody	body
bllood	blood
bloddy	bloody
blody	bloody
bloodin	blood
bloodly	bloody
bloods	blood
blooed	blood
bloood	blood
boady	body
boday	body
boddy	body
bodily	body
bodya	body
bodyac	body
bodyachesx1	bodyaches
bodyachesx2	bodyaches
bodyahces	bodyaches
bodycahes	bodyaches
bodys	body
boild	boil
boile	boil
boiled	boil
boiler	boil
boils	boil
boilto	boil
boli	boil
boody	body
boold	blood
booth	both
borke	broke
borken	broken
bothe	both
botheri	bother
bothers	bother
boths	both
bowell	bowel
boyd	body
bpain	pain
bqack	back
braeth	breath
braething	breathing
breaathing	breathing
breaht	breath
breahting	breathing
breasth	breath
breasts	breast
breathe	breath
breathed	breath
breatheing	breathing
breather	breath
breathes	breath
breathg	breath
breathi	breath
breathig	breath
breathign	breathing
breathiing	breathing
breathin	breathing
breathn	breathing
breathng	breathing
breaths	breath
breating	breathing
breatrhing	breathing
breats	breast
breatth	breath
breatthing	breathing
bretahing	breathing
brings	bring
brning	bring
broked	broke
broker	broke
bronchilitis	bronchitis
bronchititis	bronchitis
bronchitits	bronchitis
broncholitis	bronchitis
bronchtitis	bronchitis
brooke	broke
brooken	broken
brreath	breath
brreathing	breathing
brun	burn
bruning	burning
bumped	bump
bumper	bump
bumpon	bump
bumpt	bump
bumpto	bump
bumpy	bump
buring	burn
burining	burning
burned	burn
burnes	burn
burng	burn
burni	burning
burnig	burning
burnign	burning
burnin	burning
burninig	burning
burnining	burning
burninng	burning
burniong	burning
burnng	burning
burnning	burning
burns	burn
burnt	burn
burnto	burn
burrning	burning
buttlock	buttock
buttlocks	buttocks
cahe	ache
calfs	calf
can`t	cant
cannot	cant
cannt	cant
canot	cant
cantt	cant
caough	cough
caradic	cardiac
cardaic	cardiac
cardiact	cardiac
cardica	cardiac
caridac	cardiac
carmps	cramps
carrdiac	cardiac
cchest	chest
ccough	cough
cehst	chest
celll	cell
celllulitis	cellulitis
cells	cell
cellu	cell
celluilitis	cellulitis
cellul	cell
cellulities	cellulitis
cellulitisof	cellulitis
cellulitist	cellulitis
cellulitits	cellulitis
cellulitius	cellulitis
cellulittis	cellulitis
cellullitis	cellulitis
cellultiis	cellulitis
cellultitis	cellulitis
cellutlitis	cellulitis
celullitis	cellulitis
chaest	chest
changed	change
changes	change
cheast	chest
checkd	check
checke	check
checked	check
checks	check
cheecks	cheek
cheest	chest
cheif	chief
cherst	chest
chesat	chest
chesck	check
chesdt	chest
cheset	chest
chesrt	chest
chesst	chest
chestb	chest
chestn	chest
chestp	chest
chestpn	chest
chestr	chest
chests	chest
chestt	chest
chesty	chest
cheswt	chest
chets	chest
chhest	chest
chilles	chills
chillis	chills
chillls	chills
ching	chin
chnage	change
chokin	choking
chornic	chronic
chough	cough
choughing	coughing
chset	chest
claf	calf
clearacne	clearance
clearances	clearance
cleareance	clearance
clearnace	clearance
clinci	clinic
clinical	clinic
clininc	clinic
clinnic	clinic
closes	close
codl	cold
coguh	cough
coldcough	cold cough
colds	cold
coldx	cold
collapsed	collapse
collaspe	collapse
collasped	collapse
compalaint	complaint
compalint	complaint
compalints	complaint
complaints	complaint
complaitn	complaint
compliant	complaint
compliants	complaint
congesstion	congestion
congestation	congestion
congestiion	congestion
congestiong	congestion
congestions	congestion
congesttion	congestion
congetsion	congestion
consitipation	constipation
consitpation	constipation
constiaption	constipation
constipaiton	constipation
constipations	constipation
constipationx	constipation
constractions	contractions
constripation	constipation
constusion	contusion
contarctions	contractions
contispation	constipation
contracitons	contractions
contracrtions	contractions
contractiions	contractions
contractiosn	contractions
contractrions	contractions
contratcions	contractions
conttractions	contractions
contusions	contusion
contussion	contusion
contustion	contusion
coough	cough
cooughing	coughing
copugh	cough
corrected	correct
cosntipation	constipation
cougfh	cough
couggh	cough
cougha	cough
coughed	cough
coughg	cough
coughh	cough
coughhing	coughing
coughi	cough
coughig	cough
coughign	coughing
coughiing	coughing
coughin	cough
coughingx	coughing
coughiong	coughing
coughm	cough
coughn	cough
coughng	cough
coughning	coughing
coughs	cough
cought	cough
coughting	coughing
coughx	cough
coughx1	cough
coughx2	cough
coughx3	cough
coughx4	cough
cougth	cough
couhg	cough
couhgh	cough
couhging	coughing
couigh	cough
couighing	coughing
counghing	coughing
couogh	cough
couugh	cough
couughing	coughing
cpain	pain
cpough	cough
crams	cramps
crapms	cramps
crashed	crash
cring	crying
crissis	crisis
cryst	cyst
cuogh	cough
cvhest	chest
cycst	cyst
cylist	cyst
cyring	crying
cyste	cyst
cysts	cyst
dache	ache
daibetic	diabetic
dailysis	dialysis
dairrhea	diarrhea
dasy	days
dayas	days
dayss	days
ddiarrhea	diarrhea
dehdyration	dehydration
dehydartion	dehydration
dehyrdation	dehydration
denatal	dental
denatl	dental
dential	dental
deotx	detox
deperssion	depression
deppressed	depressed
deppression	depression
depresssed	depressed
depresssion	depression
despression	depression
detoxed	detox
detoxs	detox
dextox	detox
deyhdration	dehydration
diaarhrea	diarrhea
diaarrhea	diarrhea
diabectic	diabetic
diabetics	diabetic
diahrrea	diarrhea
diahrrhea	diarrhea
dialyisis	dialysis
dialys	dialysis
diarea	diarrhea
diarhrea	diarrhea
diarrahea	diarrhea
diarreah	diarrhea
diarreha	diarrhea
diarrehea	diarrhea
diarrhae	diarrhea
diarrheaa	diarrhea
diarrhead	diarrhea
diarrheal	diarrhea
diarrhear	diarrhea
diarrheax	diarrhea
diarrheax1	diarrhea
diarrheax2	diarrhea
diarrhera	diarrhea
diarrhhea	diarrhea
diarrhoea	diarrhea
diarrhrea	diarrhea
diarrihea	diarrhea
diarrrhea	diarrhea
diaylisis	dialysis
diaylsis	dialysis
didgit	digit
diffciulty	difficulty
difff	diff
diffficulty	difficulty
diffi	diff
diffic	diff
difficculty	difficulty
difficluty	difficulty
difficuilty	difficulty
difficulity	difficulty
difficullty	difficulty
difficulthy	difficulty
difficultly	difficulty
difficultty	difficulty
difficutly	difficulty
diffilculty	difficulty
diffiuclty	difficulty
digital	digit
digits	digit
diifficulty	difficulty
diizziness	dizziness
dilaysis	dialysis
dirarrhea	diarrhea
dirrahea	diarrhea
disacharge	discharge
discahrge	discharge
dischagre	discharge
discharage	discharge
discharege	discharge
discharged	discharge
discharges	discharge
dischrage	discharge
discomforts	discomfort
discomfrot	discomfort
discorder	disorder
diseases	disease
dishcarge	discharge
dishcharge	discharge
disorderly	disorder
disorders	disorder
disstress	distress
distressed	distress
dizizness	dizziness
dizzieness	dizziness
dizzienss	dizziness
dizziiness	dizziness
dizzinesss	dizziness
dizzinessx	dizziness
dizzinessx1	dizziness
dizzinessx2	dizziness
dizziniess	dizziness
dizzinness	dizziness
dizziy	dizzy
dizzniess	dizziness
dizzniness	dizziness
dizzyiness	dizziness
dizzziness	dizziness
dizzzy	dizzy
dolore	dolor
downs	down
dpain	pain
drepressed	depressed
dring	drinking
drinkg	drinking
druged	drug
drugs	drug
dsypnea	dyspnea
dsyuria	dysuria
durg	drug
dyas	days
dypsnea	dyspnea
dysnpea	dyspnea
dyspena	dyspnea
dyspenea	dyspnea
dyspenia	dyspnea
dysruia	dysuria
dyssuria	dysuria
dysuira	dysuria
eache	earache
eara	ear
earaache	earache
earacheg	earache
earaches	earache
earachex	earache
earahce	earache
earcache	earache
earcahe	earache
earche	earache
eareache	earache
earhace	earache
earing	earring
earrache	earache
easr	ears
eathing	eating
eatting	eating
eaval	evaluation
eavaluation	evaluation
eavl	evaluation
eavluation	evaluation
eblow	elbow
edemia	edema
edmea	edema
elblow	elbow
elbowed	elbow
elbows	elbow
elevatedbp	elevated_blood_pressure
eleveated	elevated
elft	left
elva	evaluation
elvaluation	evaluation
emoval	removal
eoth	etoh
epain	pain
epicgastric	epigastric
epigasrtic	epigastric
epigasteric	epigastric
epigastirc	epigastric
epigrastric	epigastric
episgastric	epigastric
episodes	episode
epistaxsis	epistaxis
epsiode	episode
epsitaxis	epistaxis
epsoide	episode
eraache	earache
erache	earache
eras	ears
espigastric	epigastric
espisode	episode
etho	etoh
ethoh	etoh
ethol	etoh
ethroat	throat
etoch	etoh
etoth	etoh
eval	evaluation
evala	evaluation
evalatuion	evaluation
evalauation	evaluation
evalaution	evaluation
evall	evaluation
evalluation	evaluation
evals	evaluation
evalu	evaluation
evalua	evaluation
evaluaation	evaluation
evaluaiton	evaluation
evalualtion	evaluation
evaluatiion	evaluation
evaluatioin	evaluation
evaluations	evaluation
evaluatuion	evaluation
evaluiation	evaluation
evalulation	evaluation
evalutaion	evaluation
evalutation	evaluation
evaualtion	evaluation
evaul	evaluation
evaulation	evaluation
evauluation	evaluation
eveal	evaluation
evealuation	evaluation
evla	evaluation
evlauation	evaluation
evual	evaluation
evualation	evaluation
evualuation	evaluation
exacerabation	exacerbation
exascerbation	exacerbation
excacerbation	exacerbation
excaerbation	exacerbation
expistaxis	epistaxis
explosure	exposure
expossure	exposure
expousre	exposure
expousure	exposure
exsposure	exposure
exspoure	exposure
extermity	extremity
extremeity	extremity
extremitiy	extremity
eyebrown	eyebrow
eyebrows	eyebrow
facail	facial
faced	face
faceial	facial
faces	face
facical	facial
faciel	facial
facila	facial
faical	facial
faliure	failure
fallc	fall
fallen	fall
falli	fall
fallin	fall
falll	fall
fallot	fall
falls	fall
fallx	fall
falnk	flank
farcture	fracture
fascial	facial
fatigued	fatigue
fatiuge	fatigue
featal	fetal
featl	fetal
feaver	fever
feeel	feel
feeeling	feeling
feeels	feels
feeet	feet
feeli	feel
feelig	feel
feeliing	feeling
feelin	feel
feelings	feeling
feell	fell
feelling	feeling
feelng	feel
feets	feet
feever	fever
feevr	fever
fefver	fever
felled	fell
fellin	fell
felll	fell
fellon	fell
fells	fell
ferquent	frequent
ferver	fever
fetel	fetal
fevber	fever
fevcer	fever
feveer	fever
fever`	fever
fever2	fever
fever3	fever
fevera	fever
fevere	fever
feverf	fever
feverm	fever
fevern	fever
feverr	fever
fevers	fever
fevert	fever
feverw	fever
feverx	fever
feverx1	fever
feverx2	fever
feverx3	fever
fevet	fever
fevewr	fever
fevfer	fever
fevre	fever
fevrer	fever
fevver	fever
fevwer	fever
fewver	fever
ffever	fever
ffrom	from
figner	finger
fiinger	finger
fingers	finger
fingert	finger
fingure	finger
flanck	flank
flankl	flank
flankpn	flank
flanks	flank
fliud	fluid
flnak	flank
fluids	fluid
fndy	fdny
folllow	follow
followed	follow
followup	follow
fooot	foot
foort	foot
footb	foot
foots	foot
foott	foot
footx	foot
forearms	forearm
foregin	foreign
forehaed	forehead
foreighn	foreign
foreing	foreign
forgein	foreign
foriegn	foreign
forieng	foreign
forigen	foreign
forms	form
fractured	fracture
fractures	fracture
fracutre	fracture
frenquency	frequency
frequencey	frequency
frequently	frequent
frever	fever
fromm	from
fronm	from
fuild	fluid
fulid	fluid
fveer	fever
fvere	fever
fwever	fever
genearl	general
genearlized	generalized
generali	general
generaliz	general
generally	general
generealized	generalized
generlaized	generalized
genreal	general
genrealized	generalized
gerenal	general
gerneral	general
gerneralized	generalized
gorin	groin
grion	groin
groain	groin
groind	groin
groine	groin
groing	growing
groins	groin
growin	growing
hace	ache
hache	headache
hadn	hand
haead	head
haeadache	headache
haeadche	headache
haed	head
haedache	headache
haematuria	hematuria
handed	hand
handle	hand
haveing	having
haven	havent
hdache	headache
heaad	head
heaadache	headache
heacdache	headache
heache	headache
heaches	headache
heada	head
headaache	headache
headac	headache
headacahe	headache
headacche	headache
headaceh	headache
headacehe	headache
headachce	headache
headached	headache
headachee	headache
headachem	headache
headacher	headache
headaches	headache
headachex	headache
headachex1	headache
headachex2	headache
headachex3	headache
headachex4	headache
headadche	headache
headae	headache
headah	headache
headahce	headache
headahces	headache
headaxche	headache
headcache	headache
headcahe	headache
headcahes	headache
headd	head
headdache	headache
heade	head
headeache	headache
headed	head
headf	head
headhace	headache
headhache	headache
headon	head
heads	head
heaedache	headache
heamaturia	hematuria
heamturia	hematuria
heand	head
heaqdache	headache
heardache	headache
hearring	hearing
hears	hear
hearth	heart
hearts	heart
heasd	head
heasdache	headache
heav	heave
heaves	heave
heavey	heavy
heavily	heavy
heaving	heave
heeadache	headache
heigh	height
hematauria	hematuria
hematouria	hematuria
hematurria	hematuria
hemmorrhage	hemorrhage
hemorraghe	hemorrhage
heqadache	headache
heradache	headache
heraing	hearing
herat	heart
hered	here
herina	hernia
hermaturia	hematuria
hernial	hernia
hernias	hernia
herpe	herpes
hersel	herself
hgih	high
hheadache	headache
highbp	high_blood_pressure
higher	high
highg	high
highly	high
hight	high
hihg	high
hipand	hip
hits	hit
hnad	hand
hpyerglycemia	hyperglycemia
htroat	throat
hurst	hurt
hursts	hurt
hurti	hurt
hurtig	hurt
hurtin	hurt
hyperextension	hypertension
hyperglycaemia	hyperglycemia
hyperglycemina	hyperglycemia
hyperglycermia	hyperglycemia
hypergylcemia	hyperglycemia
hypertenison	hypertension
hypertenstion	hypertension
hypoglycaemia	hypoglycemia
hypoglycermia	hypoglycemia
hypogylcemia	hypoglycemia
hypolglycemia	hypoglycemia
hypontension	hypotension
hypotenstion	hypotension
hyptertension	hypertension
icant	cant
iching	itching
ichting	itching
icth	itch
icthing	itching
icthy	itchy
idealation	ideation
idealtion	ideation
ideations	ideation
idelations	ideation
ifeel	feel
ihave	have
iinfection	infection
iinjury	injury
ijnury	injury
inbleed	bleed
indcution	induction
indeation	ideation
indegestion	indigestion
indexs	index
indigestion	indigestion
inductions	induction
ineed	need
infeaction	infection
infecction	infection
infecetion	infection
infeciton	infection
infectiion	infection
infectioin	infection
infections	infection
infecttion	infection
inffection	infection
inflected	infected
ingroin	groin
injjury	injury
injnury	injury
injrury	injury
injruy	injury
injuary	injury
injuiry	injury
injurey	injury
injuried	injured
injurty	injury
injuruy	injury
injuryed	injured
injuryl	injury
injuryn	injury
injurys	injury
injuryt	injury
injuryto	injury
injuryu	injury
injuryy	injury
injuury	injury
injuyr	injury
inleft	left
innjury	injury
inotx	intox
inotxicated	intoxicated
inright	right
inscect	insect
inscet	insect
insecte	insect
insects	insect
insent	sent
insite	site
instool	stool
intching	itching
intest	test
intoxc	intoxicated
intoxciated	intoxicated
intoxciation	intoxication
intoxcicated	intoxicated
intoxcication	intoxication
intoxed	intoxicated
intoxi	intoxicated
intoxiaction	intoxication
intoxic	intoxicated
intoxicaiton	intoxication
intoxications	intoxication
intoxicattion	intoxication
intoxification	intoxication
intoxs	intoxicated
intoxticated	intoxicated
intoxtication	intoxication
intract	tract
inujury	injury
inurine	urine
irriatation	irritation
irritaiton	irritation
irritational	irritation
irritations	irritation
irritiation	irritation
isde	side
issues	issue
issuses	issue
itche	itch
itches	itch
itchey	itchy
itchi	itch
itchig	itch
itchiing	itching
itchin	itching
itchiy	itchy
itchng	itch
itchting	itching
itchying	itching
ithching	itching
ithchy	itchy
ithcing	itching
ithcy	itchy
itiching	itching
itichy	itchy
itnox	intoxicated
iwant	want
joints	joint
jpain	pain
jtube	tube
kiddney	kidney
kideny	kidney
kidneys	kidney
kindey	kidney
kindney	kidney
kinee	knee
kleft	left
kneck	neck
kneed	knee
kneee	knee
kneen	knee
knees	knee
kneew	knee
knight	night
knnee	knee
kpain	pain
laaceration	laceration
labaor	labor
labored	labor
labour	labor
labwork	labor
lacaeration	laceration
lacaertion	laceration
lacareation	laceration
lacceration	laceration
lacearation	laceration
laceartion	laceration
laceeration	laceration
laceraation	laceration
laceraction	laceration
laceraqtion	laceration
lacerartion	laceration
lacerastion	laceration
laceratiion	laceration
laceratino	laceration
laceratioin	laceration
lacerationn	laceration
lacerationof	laceration
lacerationon	laceration
lacerations	laceration
lacerationt	laceration
lacerationto	laceration
laceratioon	laceration
laceratoin	laceration
laceratrion	laceration
lacerattion	laceration
lacerration	laceration
lacertaion	laceration
lacertation	laceration
lacreation	laceration
lacteration	laceration
lankle	ankle
larceration	laceration
lasceration	laceration
lasted	last
lastn	last
lastni	last
lbaor	labor
lcaeration	laceration
leaft	left
learache	earache
ledft	left
leeft	left
lefdt	left
lefet	left
lefft	left
lefrt	left
lefted	left
leftr	left
lefts	left
leftt	left
lefty	left
leggs	legs
lerft	left
letf	left
lfet	left
lflank	flank
lfoot	foot
lhand	hand
likes	like
limbs	limb
lknee	knee
llaceration	laceration
lleft	left
llower	lower
loeft	left
loewr	lower
loower	lower
losse	loss
lossof	loss
losss	loss
loweer	lower
lowere	lower
lowerr	lower
lowert	lower
lowetr	lower
lowewr	lower
lowre	lower
lowwer	lower
lpain	pain
lright	right
lshoulder	shoulder
lside	left_side
lsided	sided
ltfoot	foot
lthand	hand
ltknee	knee
ltshoulder	shoulder
ltside	left_side
lumph	lump
lumpin	lump
lumpon	lump
lumps	lump
lumpto	lump
lunmp	lump
lupm	lump
lweft	left
lwoer	lower
lwrist	wrist
mailaise	malaise
malasie	malaise
maliase	malaise
masses	mass
material	atrial
mechansim	mechanism
medcial	medical
medciation	medication
mediacal	medical
mediacation	medication
mediacl	medical
mediaction	medication
medial	medical
medica	medical
medicail	medical
medicaition	medication
medicaiton	medication
medically	medical
medicaltion	medication
medicat	medication
medicatiion	medication
medicatioin	medication
medications	medication
medicial	medical
mediciation	medication
medicinal	medical
medicla	medical
medics	medic
meeds	meds
meidcal	medical
meidcation	medication
menatal	mental
menatl	mental
menstal	mental
menstral	menstrual
menstual	menstrual
mentally	mental
mentral	mental
mentrual	menstrual
middel	middle
middler	middle
migarine	migraine
migraines	migraine
migriane	migraine
miin	mini
miini	mini
mimni	mini
minii	mini
minin	mini
minio	mini
minir	mini
minire	mini
minirg	mini
miniu	mini
miniw	mini
minmi	mini
minui	mini
mioni	mini
mirgaine	migraine
mirgraine	migraine
mmini	mini
mnii	mini
mnini	mini
mobil	mobile
moini	mini
monthly	month
moring	morning
mothers	mother
motnhs	months
mounth	mouth
mouths	mouth
movements	movement
movemnet	movement
mpain	pain
mulitiple	multiple
mulitple	multiple
multilple	multiple
multiples	multiple
muscel	muscle
muscles	muscle
muscule	muscle
muslce	muscle
mutliple	multiple
nails	nail
nakle	ankle
nare	near
naseua	nausea
nasial	nasal
nasla	nasal
nassal	nasal
nasuea	nausea
nasusea	nausea
nauasea	nausea
nauesa	nausea
nauesea	nausea
nausae	nausea
nauseas	nausea
nauseau	nausea
nauseaus	nausea
nauseax	nausea
nausesa	nausea
nauseua	nausea
naussea	nausea
ncek	neck
neack	neck
nearly	near
neausea	nausea
necka	neck
necks	neck
nedle	needle
needdle	needle
neede	need
needed	need
needel	needle
needes	needs
needl	needle
needles	needle
neeed	need
neeeds	need
nights	night
nigth	night
nkee	knee
nodes	node
noes	nose
noises	noise
noisey	noise
nosebl	nosebleed
nosebleeds	nosebleed
noses	nose
nosex	no_sex
nosie	noise
noted	note
notes	note
notifiaction	notification
notificaiton	notification
notifications	notification
notificiation	notification
notiification	notification
nouse	nose
nousea	nausea
npain	pain
nsoe	nose
nuasea	nausea
nubmness	numbness
numbeness	numbness
numbenss	numbness
numberness	numbness
numbiness	numbness
numbnesss	numbness
numbnessto	numbness
numbnessx	numbness
nummbness	numbness
numnbess	numbness
numnbness	numbness
oabdominal	abdominal
oabscess	abscess
oallergic	allergic
oaltered	altered
oasthma	asthma
oback	back
obiba	biba
obilateral	bilateral
obleeding	bleeding
oblood	blood
obody	body
obodyaches	bodyaches
observ	observe
observed	observe
oburning	burning
obwalk	ob_walk
obwalkin	ob_walkin
ochest	chest
oconstipation	constipation
ocontractions	contractions
ocough	cough
ocoughing	coughing
ocugh	cough
odiarrhea	diarrhea
odifficulty	difficulty
odizziness	dizziness
odyspnea	dyspnea
odysuria	dysuria
oelevated	elevated
oepigastric	epigastric
ofacial	facial
ofall	fall
ofbreath	breath
ofeeling	feeling
ofell	fell
ofever	fever
offace	face
ofhead	head
ofound	found
ofrom	from
ogeneral	general
ogeneralized	generalized
ohead	head
oheadache	headache
oheadaches	headache
ohematuria	hematuria
ohere	here
ohigh	high
oinjury	injury
olabor	labor
olaceration	laceration
oleft	left
olower	lower
onausea	nausea
oneck	neck
onleft	left
onse	onset
onthe	on 
onumbness	numbness
opain	pain
opains	pain
opalpitations	palpitations
opelvic	pelvic
opened	open
opener	open
oproductive	productive
orash	rash
orectal	rectal
orespiratory	respiratory
oright	right
orign	origin
oseizure	seizure
osent	sent
osepsis	sepsis
osharp	sharp
oshort	short
oshortness	shortness
osore	sore
osuture	suture
oswelling	swelling
osyncope	syncope
others	other
othroat	throat
oupper	upper
ovaginal	vaginal
overd	over
overdo	over
overdoes	overdose
overdosed	overdose
overy	ovary
ovomiting	vomiting
oweakness	weakness
owheezing	wheezing
owound	wound
p?óain	pain
p0ain	pain
paain	pain
packin	packing
pahryngitis	pharyngitis
pai8n	pain
pai9n	pain
paian	pain
paibn	pain
paihn	pain
paiin	pain
paijn	pain
paimn	pain
pain`	pain
pain0	pain
pain1	pain
pain2	pain
pain3	pain
paina	pain
painat	pain
painb	pain
painc	pain
paind	pain
paine	pain
painf	pain
painfl	pain
painfu	pain
painfull	painful
paing	pain
painh	pain
paini	pain
painic	panic
painin	pain
painj	pain
paink	pain
painl	pain
painlt	pain
painm	pain
painn	pain
painon	pain
painq	pain
painr	pain
painrt	pain
pains3	pains
painsob	pain_sob
painsts	pains
painsx	pains
painto	pain
painul	pain
painw	pain
painx	pain
painx1	pain
painx2	pain
painx3	pain
painx4	pain
painx5	pain
painx6	pain
painx7	pain
painy	pain
paion	pain
paitent	patient
paiun	pain
palipitations	palpitations
paliptations	palpitations
palpiatation	palpitation
palpiatations	palpitations
palpiltations	palpitations
palpitaiton	palpitation
palpitaitons	palpitations
palpitattion	palpitation
palpitattions	palpitations
palpitiation	palpitation
palpitiations	palpitations
palptiations	palpitations
palptitations	palpitations
pani	panic
panik	panic
panin	pain
panis	penis
paoin	pain
papilitations	palpitations
papiltations	palpitations
papin	pain
paplitation	palpitation
paplitations	palpitations
paplpitations	palpitations
paqin	pain
pasin	pain
passin	pass 
passsed	passed
patches	patch
pateint	patient
patien	patient
patients	patient
pauin	pain
pedesterian	pedestrian
pedestrain	pedestrian
pelivc	pelvic
pelivic	pelvic
peniel	penile
penies	penis
peniles	penile
pennies	penis
pennis	penis
penumonia	pneumonia
perg	pregnant
pergnancy	pregnancy
pergnant	pregnant
perscription	prescription
perscriptions	prescription
perssure	pressure
pevlic	pelvic
pfall	fall
phsych	psych
physch	psych
piain	pain
pian	pain
pianful	painful
pians	pain
pina	pain
pinke	pink
pinkey	pinkeye
pinkie	pinky
plapitations	palpitations
playin	play
plevic	pelvic
pnuemonia	pneumonia
poain	pain
porblem	problem
ports	port
posit	post
possbile	possible
possi	possible
possiable	possible
possib	possible
possibel	possible
possilbe	possible
posssible	possible
postop	post_op
ppain	pain
ppsych	psych
pqain	pain
preagnant	pregnant
preassure	pressure
preganancy	pregnancy
preganant	pregnant
pregannt	pregnant
pregenant	pregnant
pregn	pregnant
pregna	pregnant
pregnacny	pregnancy
pregnanacy	pregnancy
pregnanat	pregnant
pregnancey	pregnancy
pregnanct	pregnant
pregnants	pregnant
pregnnat	pregnant
pregnt	pregnant
prego	pregnant
pregt	pregnant
pregy	pregnant
prengant	pregnant
prengnant	pregnant
prescriptions	prescription
presssure	pressure
pressu	pressure
pressuer	pressure
pressured	pressure
pressures	pressure
pressurse	pressure
pressusre	pressure
prgenant	pregnant
probelm	problem
probelms	problem
problema	problem
problemas	problem
prodcutive	productive
promblem	problem
promblems	problem
prost	post
psain	pain
pschy	psych
pscych	psych
pscyh	psych
pshyc	psych
psot	post
psychaitric	psychiatric
psyche	psych
psycher	psych
psychi	psych
psychia	psych
psychiactric	psychiatric
psychic	psych
psycho	psych
psychos	psych
psyhc	psych
psysch	psych
ptosis	poss
pvbleed	pv_bleed
pvbleeding	pv_bleed
pysch	psych
pysche	psych
pyschiatric	psychiatric
pyshc	psych
qoute	quote
quotes	quote
raash	rash
raches	rash
radaiting	radiating
radiaiting	radiating
radiaitng	radiating
radianting	radiating
radiatiing	radiating
radiatingto	radiating
radiationg	radiating
raditating	radiating
raection	reaction
rahes	rash
rahs	rash
rahses	rashes
raidating	radiating
raidiating	radiating
ramus	rash
rasdh	rash
rashe	rash
rashed	rash
rashh	rash
rashon	rash
rashs	rash
rasht	rash
rashto	rash
rashx	rash
rashx1	rash
rashy	rash
rassh	rash
reaaction	reaction
reacation	reaction
reactal	rectal
reactiion	reaction
reacting	reaction
reactions	reaction
reactionto	reaction
reacttion	reaction
readness	redness
reanl	renal
reash	rash
reathing	breathing
recatal	rectal
recation	reaction
recatl	rectal
rectall	rectal
rectally	rectal
rectual	rectal
reddness	redness
redeness	redness
redenss	redness
rediness	redness
rednesss	redness
rednessto	redness
rednness	redness
reeval	reevaluation
referrred	referred
refferred	referred
reffill	refill
refilled	refill
refilll	refill
refills	refill
refll	fell
reight	right
remaoval	removal
remmoval	removal
remoaval	removal
remoavl	removal
removale	removal
removall	removal
removalof	removal
removals	removal
removeal	removal
remval	removal
remvoal	removal
rendess	redness
renial	renal
renoval	removal
rentention	retention
reomval	removal
repalcement	replacement
repeated	repeat
replacemnet	replacement
repsiratory	respiratory
requestiong	requesting
reraction	reaction
respi	respiratory
respiartory	respiratory
respir	respiratory
respiratiory	respiratory
respiratroy	respiratory
respo	respiratory
respriatory	respiratory
respt	respiratory
resquesting	requesting
results	result
retcal	rectal
reval	reevaluation
revaluation	reevaluation
rflank	flank
rfoot	foot
rhand	hand
rigfht	right
rigght	right
righht	right
righjt	right
righrt	right
rightn	right
rightr	right
rights	right
rightt	right
righty	right
rign	ring
rignt	right
rigth	right
rigtht	right
rihgt	right
riight	right
ringer	finger
ringin	ring
rings	ring
rioght	right
rknee	knee
rlower	lower
rpain	pain
rrash	rash
rright	right
rshoulder	shoulder
rside	side
rtankle	ankle
rtfoot	foot
rthand	hand
rtight	right
rtknee	knee
rtlower	lower
rtshoulder	shoulder
rtside	side
ruled	rule
runing	running
runnny	runny
runnyn	runny
saide	side
sawelling	swelling
scapel	scalpel
scapl	scalpel
scaple	scalpel
scell	cell
schoulder	shoulder
scik	sick
sclap	scalp
scores	score
scorethroat	sorethroat
sdie	side
sections	section
seizrue	seizure
seizuer	seizure
seizured	seizure
seizurez	seizure
seizurre	seizure
seizzure	seizure
sensat	sensation
sensations	sensation
senstation	sensation
sentby	sent
servere	severe
sespis	sepsis
severed	severe
severely	severe
severve	severe
sewelling	swelling
sewlling	swelling
seziure	seizure
seziures	seizures
sezuire	seizure
sezuires	seizures
shacking	shaking
shakeing	shaking
shakin	shaking
shanking	shaking
sharpe	sharp
shaved	shave
shivers	shiver
shoertness	shortness
sholuder	shoulder
sholulder	shoulder
shoot	shot
shoots	shot
shooulder	shoulder
shopulder	shoulder
shore	sore
shorntess	shortness
shorten	short
shorteness	shortness
shorth	short
shorthness	shortness
shortn	short
shortne	short
shortnessof	shortness
shortnesss	shortness
shotrness	shortness
shots	shot
shoudler	shoulder
shouilder	shoulder
shouklder	shoulder
shouldeer	shoulder
shoulderr	shoulder
shoulders	shoulder
shoullder	shoulder
shrotness	shortness
shugar	sugar
shuolder	shoulder
sicjk	sick
sickcle	sickle
sicke	sickle
sickel	sickle
sickele	sickle
sickell	sickle
sickl	sickle
sickler	sickle
sickles	sickle
sickw	sick
siclke	sickle
sicne	since
sideded	sided
sidee	side
sideed	sided
sideof	side
sides	side
sidew	side
sidewa	side
sied	side
siezure	seizure
siezures	seizure
siince	since
sikc	sick
sinces	since
sinsus	sinus
sinuses	sinus
sisded	sided
sised	side
sites	site
siucidal	suicidal
sixck	sick
sking	skiing
skinn	skin
skins	skin
smokin	smoking
snet	sent
snores	snore
snycope	syncope
soare	sore
soer	sore
soerthroat	sorethroat
somethings	something
sored	sore
soree	sore
sorehtroat	sorethroat
sorerthroat	sorethroat
sores	sore
soret	sore
soreth	sore
sorethoart	sorethroat
sorethorat	sorethroat
sorethraot	sorethroat
sorethroath	sorethroat
sorethroatx	sorethroat
sorethtroat	sorethroat
soretrhoat	sorethroat
sorre	sore
sorrethroat	sorethroat
sorte	sore
sosre	sore
sotmach	stomach
source	sore
souture	suture
sowllen	swollen
spain	pain
spesis	sepsis
spots	spot 
spottting	spotting
spraine	sprain
sprained	sprain
sprains	sprain
spraying	sprain
sprian	sprain
spych	psych
sshoulder	shoulder
ssore	sore
sstomach	stomach
sswelling	swelling
stample	staple
staomach	stomach
stapel	staple
stapels	staple
stapled	staple
stapler	staple
staples	staple
stapple	staple
stapples	staple
staring	strain
starte	state
started	state
stated	state
staten	state
statesi	states
statue	state
stauts	status
sten	sent
stent	sent
stents	sent
stich	stitches
sticks	stick
sticky	stick
stictches	stitches
sticthes	stitches
stie	site
stitch	stitches
stitching	stitches
stitiches	stitches
stoamach	stomachache
stoamch	stomach
stoamche	stomach
stomaach	stomachache
stomacha	stomach
stomache	stomach
stomachs	stomach
stomahc	stomach
stomatch	stomach
stomcah	stomach
stoole	stool
stools	stool
stoool	stool
stopmach	stomach
store	tore
storke	stroke
strained	strain
strains	strain
strated	state
strcuk	struck
streets	street
strenal	renal
strick	stick
strokes	stroke
stromach	stomach
strucked	struck
stucked	stuck
stuckin	stuck
stucks	stuck
sturck	struck
stuture	suture
suagr	sugar
sucicidal	suicidal
sucide	suicide
sucidial	suicidal
sucture	suture
sudicidal	suicidal
sugars	sugar
suicdial	suicidal
suiciadal	suicidal
suicideal	suicidal
suicidial	suicidal
suicidual	suicidal
suiture	suture
sulture	suture
surgar	sugar
surgerical	surgical
surgrey	surgery
surigical	surgical
surture	suture
sutrue	suture
sutrure	suture
sutture	suture
sutuer	suture
sutured	suture
suturel	suture
suturer	suture
sutures	suture
sututre	suture
swealling	swelling
sweelling	swelling
sweilling	swelling
swelilng	swelling
swellg	swelling
swelli	swelling
swellign	swelling
swelliing	swelling
swellilng	swelling
swellimng	swelling
swellingg	swelling
swellingh	swelling
swellingn	swelling
swellingof	swelling
swellings	swelling
swellingt	swelling
swellingto	swelling
swellingx	swelling
swellingx1	swelling
swellingx2	swelling
swellingx3	swelling
swellinng	swelling
swelliong	swelling
swellling	swelling
swelln	swelling
swellnig	swelling
swelloing	swelling
swellowing	swelling
swells	swelling
sweollen	swollen
swollened	swollen
swollenn	swollen
swollens	swollen
swollent	swollen
swolllen	swollen
swolloen	swollen
swollwen	swollen
swoollen	swollen
swore	sore
swwelling	swelling
sycnope	syncope
sydnrome	syndrome
sympotoms	symptoms
sympstoms	symptoms
sympthoms	symptoms
symptomes	symptoms
symptomps	symptoms
symptomsx1	symptoms
symptomsx2	symptoms
symptomsx3	symptoms
symtopms	symptoms
symtpoms	symptoms
syncoope	syncope
syncoped	syncope
syncopel	syncope
syncopes	syncope
syncopide	syncope
syncopied	syncope
syncopize	syncope
syncpoe	syncope
syndromes	syndrome
synocope	syncope
synocpe	syncope
synscope	syncope
sypmtoms	symptoms
sysmptoms	symptoms
taruma	trauma
teriage	triage
teste	test
tested	test
testes	test
testi	test
testic	testicular
testicluar	testicular
testicualr	testicular
testin	test
testis	test
tests	test
theigh	thigh
theres	there
thhroat	throat
thighs	thigh
thight	thigh
thightness	tightness
thights	thigh
thigtness	tightness
thingh	thing
things	thing
thinks	think
thisam	this_am
thoart	throat
thooth	tooth
thoothache	toothache
thorat	throat
thoroat	throat
thraot	throat
threatenend	threatened
threathened	threatened
thrioat	throat
throaat	throat
throart	throat
throast	throat
throate	throat
throath	throat
throatr	throat
throats	throat
throatt	throat
throatx	throat
throatx2	throat
throatx3	throat
throaty	throat
throuble	trouble
thrroat	throat
thrumb	thumb
thsi	this
thuimb	thumb
thumbs	thumb
tiching	itching
tighntess	tightness
tighteness	tightness
tightiness	tightness
tightnesss	tightness
tigthness	tightness
tihgtness	tightness
tingeling	tingling
tingiling	tingling
tingleing	tingling
tirage	triage
tissues	tissue
toady	today
toback	back
tobody	body
toboth	both
todays	today
todya	today
toface	face
tohead	head
toleft	left
tolegs	legs
tolower	lower
tonight	night
tonuge	tongue
toooth	tooth
tooothache	toothache
tootchache	toothache
tootha	tooth
toothaache	toothache
toothac	tooth
toothaceh	toothache
toothaches	toothache
toothachex	toothache
toothahce	toothache
toothe	tooth
tootheache	toothache
toright	right
toruble	trouble
touble	trouble
tounge	tongue
toungue	tongue
tpain	pain
trache	ache
tracht	tract
traige	triage
tramautic	traumatic
tramua	trauma
trauam	trauma
trauama	trauma
trauamatic	traumatic
trauamtic	traumatic
trauma1	trauma
trauma2	trauma
trauma3	trauma
traumaatic	traumatic
traumaic	trauma
traumaitc	traumatic
traumas	trauma
traumat	trauma
traumataic	traumatic
traumatc	trauma
traumati	trauma
traumatiac	traumatic
trhoat	throat
trhroat	throat
triaeg	triage
triaged	triage
trigae	triage
troubled	trouble
troubles	trouble
truama	trauma
truamatic	traumatic
truble	trouble
truoble	trouble
tthroat	throat
tubed	tube
tubes	tube
twiching	twitch
twitching	twitch
twsited	twisted
uanble	unable
ucler	ulcer
ulceres	ulcer
ulcers	ulcer
unabel	unable
unabled	unable
unableto	unable
unalbe	unable
unbale	unable
underam	underarm
unrepsonsive	unresponsive
unresp	unresponsive
unresponisve	unresponsive
unrinary	urinary
unrinate	urinate
unrinating	urinating
unrination	urination
unrine	urine
unspcfd	unspec
unspeci	unspec
unspecif	unspec
uppeer	upper
uppper	upper
uraination	urination
urianary	urinary
urianry	urinary
uriante	urinate
urianting	urinating
uriantion	urination
urinaiton	urination
urinanry	urinary
urinantion	urination
urinartion	urination
urinarty	urinary
urinated	urinate
urinates	urinate
urinatiing	urinating
urinatiion	urination
urinationg	urination
urinations	urination
urinationx	urination
urinattion	urination
urinery	urine
urines	urine
uring	urine
uriniating	urinating
uriniation	urination
urintaion	urination
urintating	urinating
urintation	urination
urinte	urine
urniary	urinary
urniate	urinate
urniating	urinating
urniation	urination
urnie	urine
urninary	urinary
urnination	urination
urnine	urine
urning	urine
urnitation	urination
vaaginal	vaginal
vagainal	vaginal
vagianal	vaginal
vagianl	vaginal
vagibnal	vaginal
vagiinal	vaginal
vaginall	vaginal
vaginally	vaginal
vagingal	vaginal
vaginia	vagina
vaginial	vaginal
vaginla	vaginal
vaginnal	vaginal
vagional	vaginal
vagnial	vaginal
vagninal	vaginal
vaignal	vaginal
vanginal	vaginal
varginal	vaginal
vasginal	vaginal
veal	evaluation
vechicle	vehicle
vechile	vehicle
vehcile	vehicle
vehichle	vehicle
vehilce	vehicle
vioces	voices
viomiting	vomiting
viomitting	vomiting
visiion	vision
visions	vision
visison	vision
visita	visit
visited	visit
visitor	visit
visits	visit
vission	vision
vocies	voices
voimiting	vomiting
voimitting	vomiting
voimting	vomiting
vomiiting	vomiting
vomiitng	vomiting
vominiting	vomiting
vominting	vomiting
vomioting	vomiting
vomite	vomit
vomited	vomit
vomitg	vomit
vomithing	vomiting
vomiti	vomit
vomitig	vomit
vomitign	vomiting
vomitiing	vomiting
vomitin	vomit
vomiting3	vomiting
vomitinga	vomiting
vomitingg	vomiting
vomitingm	vomiting
vomitingn	vomiting
vomitingq	vomiting
vomitings	vomiting
vomitingt	vomiting
vomitingx	vomiting
vomitingx1	vomiting
vomitingx2	vomiting
vomitingx3	vomiting
vomitingx4	vomiting
vomitinig	vomiting
vomitinng	vomiting
vomitiong	vomiting
vomititing	vomiting
vomititng	vomiting
vomitn	vomit
vomitng	vomit
vomitnig	vomiting
vomitning	vomiting
vomito	vomit
vomitos	vomit
vomits	vomit
vomitt	vomit
vomitte	vomit
vomitti	vomit
vomitting	vomiting
vomittting	vomiting
vomitus	vomit
vommit	vomit
vommiting	vomiting
vommitt	vomit
vommitting	vomiting
vomniting	vomiting
vomoiting	vomiting
vomtiing	vomiting
vomtin	vomit
vomtiting	vomiting
vonmiting	vomiting
voomiting	vomiting
vopmiting	vomiting
vvomiting	vomiting
waek	weak
waekness	weakness
wakl	walk
walked	walk
walker	walk
walki	walk
walkiin	walking
walkk	walk
walkn	walk
walks	walk
wanted	want
wasnts	wasn?Æt
watery	water
weack	weak
weackness	weakness
weakeness	weakness
weakenss	weakness
weaker	weak
weakiness	weakness
weakkness	weakness
weakn	weak
weakne	weak
weakneess	weakness
weaknessor	weakness
weaknesss	weakness
weaknessx	weakness
weaknessx1	weakness
weaknness	weakness
weakns	weak
weaks	weak
weankess	weakness
weaskness	weakness
weeakness	weakness
weeek	week
weeeks	weeks
weekd	week
weekes	weeks
weekly	week
wekaness	weakness
welll	well
wheeezing	wheezing
wheezeing	wheezing
wheezhing	wheezing
wheezzing	wheezing
wifever	fever
wiht	with
windex	index
wioth	with
wirst	wrist
withd	with
withdr	withdrawal
withdrawals	withdrawal
withn	within
witho	with
withou	without
wlak	walk
wnats	wants
woound	wound
worke	work
worked	work
worker	work
worki	work
workin	work
works	work
workup	work
woudn	wound
wouind	wound
wounded	wound
wounds	wound
wounnd	wound
wouund	wound
wright	right
wrisit	wrist
wrists	wrist
writs	wrist
writst	wrist
wrsit	wrist
wselling	swelling
wtih	with
wweakness	weakness
x1days	days
x1month	month
x1week	week
x1weeks	week
x2days	days
x2month	month
x2months	month
x2week	week
x2weeks	week
x3days	days
x3month	month
x3months	month
x3weeks	week
x4days	days
x4months	month
x4weeks	week
x5days	days
x5months	month
x6days	days
x6months	month
x6weeks	week
x7days	days
x8days	days
x9days	days
xdays	days
xlast	last
xmonth	month
xmonths	month
xthis	this
xtoday	today
xweek	week
xweeks	week
xyesterday	yesterday
yersterday	yesterday
yesteday	yesterday
yesterda	yesterday
yesterdays	yesterday
yestersday	yesterday
yestreday	yesterday
yestureday	yesterday
ysterday	yesterday
ystereday	yesterday
